5
E 1 1 1 1
0 0 0 1 1
1 1 1 0 1
C C 0 0 1
1 1 1 1 1