5
E 1 1 1 1
0 0 0 1 1
1 1 1 0 1
0 0 0 1 1
1 1 1 1 1

1
X 1 1 1 1
0 0 0 1 1
1 1 1 C 1
C 0 0 1 1
1 1 1 1 1
